0025DC0E 00000080
0025DC4E 00000080
0025E10E 00000080
0025DC8E 000000A0
0025E5CE 00000080
0025E5BE 000000A0
0025DCCE 00000080
0025DD0E 00000080
0025DD4E 00000080
0025DD8E 00000080
0025E00E 00000080
0025DDCE 00000080
0025DE0E 00000080
0025DE4E 00000080
0025DE9E 00000080
0025DECE 00000080
0025DF0E 00000080
0025DF4E 00000080
0025E64E 00000080
0025DF8E 00000080
0025DFCE 00000080
0025E0CE 00000080
0025E14E 00000080
0025E18E 00000080
0025E1CE 00000080
0025E20E 00000080
0025E38E 00000080
0025E84E 00000080
0025E28E 00000080
0025DE8E 00000080
0025E60E 00000080
